#############
#S....#....S#
#.#...#...#.#
#..#.....#..#
###...P...###
#..#.....#..#
#.#...#...#.#
#S....#....S#
#############
